"filename", "language", "C#", "comment", "blank", "total"
"f:\Unity\The Mass Hit\Assets\Scripts\AirCraftModeSwitch.cs", "C#", 28, 6, 3, 37
"f:\Unity\The Mass Hit\Assets\Scripts\AudioPeer.cs", "C#", 3, 0, 0, 3
"f:\Unity\The Mass Hit\Assets\Scripts\CharacterCtrl.cs", "C#", 32, -14, 0, 18
"f:\Unity\The Mass Hit\Assets\Scripts\GlobalRules.cs", "C#", 2, 0, -1, 1
"f:\Unity\The Mass Hit\Assets\Scripts\PlayerBrain.cs", "C#", -5, 5, 1, 1
"f:\Unity\The Mass Hit\Assets\Scripts\UIElements\EscUI.cs", "C#", 1, 1, -1, 1
"f:\Unity\The Mass Hit\Assets\Scripts\UIElements\GlobalUIFunctions.cs", "C#", 20, 15, -2, 33
"f:\Unity\The Mass Hit\Assets\Scripts\UIElements\MissionTextCrtl.cs", "C#", 0, 0, -1, -1
"f:\Unity\The Mass Hit\Assets\Scripts\UIElements\UIManager.cs", "C#", -10, 13, -2, 1
"Total", "-", 71, 26, -3, 94