"filename", "language", "C#", "comment", "blank", "total"
"f:\Unity\The Mass Hit\Assets\Scripts\AudioPeer.cs", "C#", 49, 24, 12, 85
"f:\Unity\The Mass Hit\Assets\Scripts\BackGroundMusicCtrl.cs", "C#", 25, 6, 6, 37
"f:\Unity\The Mass Hit\Assets\Scripts\BlackHoleAttraction.cs", "C#", 36, 8, 7, 51
"f:\Unity\The Mass Hit\Assets\Scripts\BlackHoleDestory.cs", "C#", 31, 1, 3, 35
"f:\Unity\The Mass Hit\Assets\Scripts\BulletDestory.cs", "C#", 29, 5, 10, 44
"f:\Unity\The Mass Hit\Assets\Scripts\ButtonSoundCtrl.cs", "C#", 36, 1, 3, 40
"f:\Unity\The Mass Hit\Assets\Scripts\CameraDistMain.cs", "C#", 77, 16, 16, 109
"f:\Unity\The Mass Hit\Assets\Scripts\CameraDistSecond.cs", "C#", 59, 2, 13, 74
"f:\Unity\The Mass Hit\Assets\Scripts\CharacterCtrl.cs", "C#", 311, 91, 54, 456
"f:\Unity\The Mass Hit\Assets\Scripts\CheckPoint.cs", "C#", 53, 2, 11, 66
"f:\Unity\The Mass Hit\Assets\Scripts\FloatOnWater.cs", "C#", 54, 22, 4, 80
"f:\Unity\The Mass Hit\Assets\Scripts\GlobalRules.cs", "C#", 148, 51, 29, 228
"f:\Unity\The Mass Hit\Assets\Scripts\GravityCubeAction.cs", "C#", 28, 4, 3, 35
"f:\Unity\The Mass Hit\Assets\Scripts\GunScript.cs", "C#", 77, 11, 11, 99
"f:\Unity\The Mass Hit\Assets\Scripts\Interceptor.cs", "C#", 41, 2, 8, 51
"f:\Unity\The Mass Hit\Assets\Scripts\JumpPad.cs", "C#", 18, 8, 4, 30
"f:\Unity\The Mass Hit\Assets\Scripts\MissionScripts\Level1\GetKernel.cs", "C#", 31, 2, 5, 38
"f:\Unity\The Mass Hit\Assets\Scripts\PlayerBrain.cs", "C#", 61, 28, 14, 103
"f:\Unity\The Mass Hit\Assets\Scripts\SavedData.cs", "C#", 9, 0, 2, 11
"f:\Unity\The Mass Hit\Assets\Scripts\SpectatorCtrl.cs", "C#", 73, 8, 22, 103
"f:\Unity\The Mass Hit\Assets\Scripts\SwitchBlockCtrl.cs", "C#", 72, 26, 15, 113
"f:\Unity\The Mass Hit\Assets\Scripts\UIElements\EscUI.cs", "C#", 117, 33, 27, 177
"f:\Unity\The Mass Hit\Assets\Scripts\UIElements\GlobalUIFunctions.cs", "C#", 112, 15, 24, 151
"f:\Unity\The Mass Hit\Assets\Scripts\UIElements\MissionTextCrtl.cs", "C#", 132, 35, 17, 184
"f:\Unity\The Mass Hit\Assets\Scripts\UIElements\SpectatorUI.cs", "C#", 74, 3, 8, 85
"f:\Unity\The Mass Hit\Assets\Scripts\UIElements\StartMenuManager.cs", "C#", 87, 8, 10, 105
"f:\Unity\The Mass Hit\Assets\Scripts\UIElements\UIEffect.cs", "C#", 12, 1, 2, 15
"f:\Unity\The Mass Hit\Assets\Scripts\UIElements\UIManager.cs", "C#", 170, 32, 51, 253
"f:\Unity\The Mass Hit\Assets\Scripts\WaterWithCamera.cs", "C#", 22, 1, 2, 25
"f:\Unity\The Mass Hit\Assets\Scripts\particleAttractorLinear.cs", "C#", 32, 1, 1, 34
"Total", "-", 2076, 447, 394, 2917